11111111
11111111
11E0C011
11P00011
11111111
11111111