11111111
11111111
11E0C011
11000P11
11111111
11111111