11111111111
1P0C0C0E001
11101110111
1C0C0C0C001
11111111111