11111111111111111111111111111111111111
10001111100000000000000110000001111111
10000000001101111111010010111101001001
10001111100101000001010000011101101011
11100011110101111101000101000100000011
11101111010100000001111111011101111011
11100000010111111101000001000001001011
11101101010000001101010001011101001011
11000101011110001111011101010000011001
11011101000011111000000001011111111001
11000001C01010000010111111000100001001
11001111111011110010100001010101111111
1110100000100001P0101010C1010100000001
10000010100010C11110001111010111101101
10101110111011110001011010010000001101
10000010111000000111011010011111111001
11111010000011011100000010010000010001
10000010111111000101111010010000010001
101111101000010001010C1011010000010001
100000001011010000010010011100E0011011
11110110101101000101000100100000001011
10000110101101111111110110100000001011
10110110100101000010000010100000001011
10100C10111101111010111110111101111011
11100010000000000010000000100000000011
11111111111111111111111111111111111111